###############################
#.....#.....#........#........#
#..####..##########..#######..#
#..........................#..#
#..####..####..#######..####..#
#..#..#..#..#..#..#...........#
#..#..####..#..#..#..#..####..#
#.....#........#.....#..#.....#
#..###################..#..####
#.....#..#........#.....#..#..#
#..####..####..#######..#..#..#
#...........#..#..#..#..#..#..#
##########..#..#..#..####..#..#
#..#..#........#.....#..#..#..#
#..#..#..#..#######..#..#..#..#
#........#.....#..#..#..#.....#
#..####..#######..#..#..#######
#..#........#.....#...........#
#######..#######..#..#..####..#
#....................#..#.....#
#############################A#
