#######################################################################################################################################################
#..#.....#....................#..#..#..#...........#..............#........#.....#..#..............#..#.................#..#..#.....#...........#..#..#
#..#..#######..####..####..####..#..#..####..################..####..#..#..#..#..#..#######..####..#..#..#..#..#######..#..#..#..#..##########..#..#..#
#........#..#..#.....#..........................#........#..#........#..#.....#.................#........#..#..#..#.....#.....#..#..#..#..............#
#######..#..#..#######..#############..#######..#..####..#..#..#..#######..####..################..#######..####..####..#..####..#..#..####..##########
#........#.....#..#..#.....#.................#.....#..#.....#..#.....#.....#........#........#.....#..#..#...........#..#.....#..#.................#..#
#..#######..#..#..#..####..#..####..################..#..####..#######..####..#..#..####..####..####..#..#..#..####..#######..#######..#..####..#..#..#
#.....#.....#..#.....#.....#.....#.................#..#.....#.....#.....#.....#..#...........#..#...........#..#..#........#..#..#.....#..#.....#.....#
#..####..#..#..#..###################..####..#..####..#..#..#..#..##########..##########..##########..#..####..#..#..####..#..#..####..#############..#
#........#..#.....#.....#.....#..#.....#..#..#..#.....#..#.....#.....#.....#.....#..#..............#..#..#.....#.....#........#.....#........#.....#..#
####..#..#..#..#######..#..####..####..#..#######..#######..####..####..##########..#..####..################..#############..#..#..#..#..####..#..#..#
#.....#..#..#..#.....#..#.....#..#.......................#..#........#..#.....#.....#..#........#..#..#...........#.....#..#..#..#..#..#..#.....#..#..#
#..#######..#######..#..#..####..#..#..#######..#..#..#######..####..#..####..####..#..####..#..#..#..####..#..####..####..####..#######..#..#..#..#..#
#..#.....#...........#........#.....#.....#.....#..#..#.....#.....#........#..#..#........#..#........#.....#........#.....#..#........#..#..#..#.....#
#..#..####..####..#..#######..#..####..####..####..####..#..#######..#..#..#..#..#..####..#..#..#############..##########..#..#..#######..##########..#
#.....#.....#.....#..#.....#........#..#........#..#.....#..#.....#..#..#..#.....#.....#..#..#...........#........#.....#..#........#...........#.....#
#..#..#..#..#############..#..#..#..##########..####..##########..#..##########..#############..#..####..#..##########..#..####..####..################
#..#..#..#.....#...........#..#..#...........#..#.....#.....#........#..#........#........#.....#..#..#..#.....#.....#...........#.....#........#..#..#
####..####..#######..####..####..#######..#..#######..####..#..#..#..#..####..#######..#..####..####..####..####..#############..####..####..####..#..#
#.....#.....#..#..#..#.....#........#..#..#........#..#........#..#.....#........#..#..#..#........#.....#........#.......................#.....#.....#
#..####..####..#..#..################..#######..#..#..####..####..#..#..#######..#..####..####..#..####..####..#..#..#..##########..####..#..#######..#
#..#..#..#..............#..#........#........#..#..#.....#..#..#..#..#..#........#.....#..#.....#........#..#..#.....#.....#..#........#..#..#..#..#..#
####..####..#..##########..#..##########..##########..#######..####..####..#######..#..#..#..#..#######..#..#..####..#######..####..####..#..#..#..#..#
#..#..#..#..#..#.....#..#.....#.....#.....#..#..............#..............#........#..#.....#.....#........#..#........#..#..#..#..#..#...........#..#
#..#..#..#..#..####..#..#..#..#..####..####..#..####..####..####..#######..##########..#..#..#..###################..####..#..#..####..####..#######..#
#..#........#..#..#........#.....#..#..#..#.....#..#.....#.....#........#..#..#.....#..#..#..#........#..#.....#........#..#........#..#.....#..#.....#
#..#..####..####..#..#..#..####..#..#..#..#..#..#..#..#######..#..####..####..#..####..##########..####..####..####..#..#..#######..#..#..#..#..#..####
#.....#..............#..#.....#..#...........#.....#..#.....#..#..#..#..#..#...........#.....#.....#.................#..............#.....#..#........#
####..####..#######..#######..#..#######..#..##########..#..#######..#..#..####..#..#######..####..#######..#######..#..##########..####..####..#######
#.....#..#........#..#.....#..#.....#.....#..#.....#.....#..#..............#.....#.....#..#..#..#..#..#..#.....#..#..#..#..#........#.....#...........#
#..####..#..##########..#..#..#..#######..####..####..#######..##########..####..#..####..#..#..#..#..#..#..####..#######..####..################..#..#
#..#........#...........#..#..#...........#........#.....#..#........#........#..#..#...........#.....#..#..............#........#.....#..#........#..#
#######..#..####..####..#######..################..#..#..#..#..#######..##########..#..####..#######..#..#######..#..####..#..#..####..#..#..##########
#........#........#..#.....#...........#...........#..#...........#..#..#...........#..#........#.....#..#..#..#..#..#..#..#..#..#..#........#........#
####..#..####..####..#..#..##########..#..#############..#..#..####..#..#..#..#..####..####..#######..#..#..#..####..#..#..####..#..#..#############..#
#..#..#..#..#..#.....#..#.....#...........#...........#..#..#..#........#..#..#...........#........#...........#.....#.....#..#.......................#
#..#..####..#..#..#..#######..#######..####..####..################..#..#######..#..################..#..####..#..####..####..#..##########..#..####..#
#..#..#..#........#........#..#..#...........#........#..............#........#..#........#..#.....#..#..#.....#.....#.....#..#..#........#..#.....#..#
#..####..#..#############..####..#..####..####..#..####..##########..#..#..##########..#..#..#..####..####..#..#..#..#######..#######..#..####..####..#
#..#.....#..............#..#..#........#..#.....#.....#.....#..#.....#..#.....#........#..#........#..#.....#..#..#..#........#........#...........#..#
#..#..####..#############..#..#..#######..#..################..#..####..#..####..#######..#..####..####..#######..####..##########..#######..##########
#..#........#.....#..#.....#...........#..#.....#..............#.....#..#..#..#..#..............#.....#........#........#...........#.....#.....#..#..#
#..#..####..#..####..#######..#######..#..####..#..####..#..##########..#..#..#..####..################..#############..####..#..####..##########..#..#
#........#..#..#........#..#........#..#..#.....#..#.....#.....#........#..#..#..#.....#.....#........#........#.....#..#..#..#.....#........#..#.....#
#..##########..#..####..#..#..####..#########################..#..#..####..#..#..##########..#..#..#..#..####..####..####..####..##########..#..#..#..#
#..#..#.....#........#.....#.....#.....#..............#........#..#..#..#..#..#..#.....#..#.....#..#........#..#........#.....#..#...........#..#..#..#
#..#..#..####..#..#..####..####..#############..#######..####..####..#..####..#..####..#..#..################..#..####..#..#..####..####..####..#..####
#..#.....#.....#..#..#..#........#........#........#........#..#.......................#.................#...........#.....#.....#.....#..#........#..#
#..####..#..#######..#..####..####..##########..#..#######..####..##########..#############..####..#######..#..#..####..####..####..#..#..#..####..#..#
#..#........#........#........#.....#.....#.....#........#.................#..#...........#.....#..#..#..#..#..#..#........#..#..#..#..#..#..#..#..#..#
####..#..#..#######..####..#..#..#..#..####..#######..#######..##########..####..##########..#..####..#..#..####..####..#..#..#..####..#######..#..#..#
#..#..#..#..#.....#..#.....#..#..#..#.....#..#.....#.....#..#........#..#........#...........#..#.....#..#..#.....#.....#..#.....#.....#.....#........#
#..#######..####..#..#######..####..####..####..#######..#..#######..#..#############..#######..####..#..#..####..#############..#..####..####..####..#
#.....#...........#........#..#........#........#..#...........#........#..............#........#..#.....#..#.....#..#.....#..............#........#..#
####..#############..####..#######..####..#..####..#######..#######..################..##########..####..#..#..####..#..#############..##########..####
#..#....................#........#.....#..#...........#....................#..#........#.....#..............#..#..#.....#........#..#..#..#...........#
#..#..####..##########..#..#..#..#..#..#######..####..##########..#..#######..##########..######################..####..#######..#..#..#..#..#######..#
#........#........#..#..#..#..#..#..#.....#.....#..#.....#.....#..#.....#..#.....#.....#..#........#...........#..#.....#..#..#..#.................#..#
#..#######..#..#..#..####..##########..####..#..#..#..#..#..#..#..#######..#..####..#..#..#######..####..####..#..#..####..#..#..#######..#..####..####
#..#........#..#........#.....#..#...........#..#..#..#..#..#.....#.....#...........#..#........#...........#..............#........#.....#.....#.....#
#..################..####..####..#..#..#..#######..#############..#..####..####..#######..####..####..##########..##########..####..#..#############..#
#..#.....#.....#........#........#..#..#........#...........#.....#..#.....#.....#........#.....#.....#..#.....#..#........#..#.....#..............#..#
####..#######..#..####..#############..##########..#######..####..#..#..#######..#######..#############..#..#..#..####..####..####..####..#############
#.....#........#..#...........#...........#........#.....#..#.....#.....#..#........#.....#..#...........#..#..#..#.....#..#..#........#.....#........#
####..#..#..####..#############..#..##########..#######..#..####..#..####..#######..####..#..####..#..####..#..#..####..#..####..#######..####..#######
#.....#..#...........#..#..#.....#.................#.....#.....#........#........#..#..#..#..#.....#..#.....#..#.....#..#.....#.......................#
#..#..#..#..##########..#..####..####..####..#######..#############..#..#..##########..#..#..#..####..####..####..#..#..#..##########..#..#..#..#..####
#..#.....#........#.....#..#..#..#..#.....#..#........#........#..#..#.....#..............#.....#..............#..#........#........#..#..#..#..#.....#
#..####..#############..#..#..#..#..##########..#######..#######..#######..#######..####..#..#######..#..#############..#######..#..####..####..#..####
#.....#..#.................#..............#...........#.....#..............#........#..#.....#........#..#..#...........#..#.....#.....#..#.....#..#..#
#..####..#..####..#..####..#..#######..#..#..#..#######..####..#..####..#..##########..#############..#..#..#..####..####..#######..#############..#..#
#.....#.....#.....#.....#..#..#.....#..#..#..#.....#...........#.....#..#..#.................#........#.....#.....#..#........#..#.....#........#.....#
#..#######..####..#..#..#..####..#######..####..##########..#############..####..##########..#..####..#..##########..#..####..#..#..#..#..#..#######..#
#........#..#.....#..#..#.....#..#....................#.....#.....#........#........#........#..#.....#..............#.....#.....#..#..#..#..#..#.....#
#..#######..#..#############..#..##########..#######..#..####..####..#######..##########..#######..#..####..#######..#..##########..####..####..#..#..#
#........#..#..#..#..#..#..#.....#..#.....#..#..#.....#.....#...........#.....#.....#.....#.....#..#..#.....#........#.....#.....#.................#..#
#..#..##########..#..#..#..#..####..#..####..#..####..#..################..####..####..#######..#..#..####..#######..####..#..####..#############..#..#
#..#........#..#.....#....................#........#........#..#.....#.....#..............#........#..#..#........#..#..#..#..#..#.....#........#..#..#
#..####..#..#..####..####..#..####..#..#######..####..#######..#..####..#..#######..####..#..##########..#..####..####..#..#..#..#..#######..####..####
#..#.....#........#........#..#..#..#...........#..#........#.....#.....#..#........#...........#.....#..#.....#..#...........#.....#..#........#..#..#
##########..####..#######..####..####..####..####..#..#######..####..#############..#######..#######..#..#..#######..####..####..####..####..####..#..#
#.....#........#..#........#.....#.....#...........#..#..#........#..#........#.....#..#.....#.....#..#..#..#..#..#..#..#..#..#...........#...........#
#..##########..#######..#..####..#..###################..####..#############..####..#..#..#######..#..#..####..#..#..#..#..#..#..#..#######..#..####..#
#.....#..#.....#..#..#..#..#.....#........#.....#.....#........#...........#........#.....#..#..#..#..#.....#........#..#........#........#..#..#.....#
#..####..#######..#..#..#######..#..#..####..####..#..#..#..#############..#..#######..####..#..#..#..#..####..#######..####..#..#..#######..##########
#..#...........#.....#..#..#.....#..#...........#..#..#..#..............#........#..#.....#..#..#........#..............#.....#..#.....#..............#
#..####..#######..#######..#..#..####..#######..#..#..####..#..################..#..#######..#..#######..####..#######..####..#..#######..#######..####
#..#.....#........#.....#.....#........#..#.....#..#..#.....#..#........#.....#........#..#..............#..#..#..#.....#.....#........#..#..#.....#..#
#..####..#..#######..####..#######..####..####..####..####..#..#..####..#..#######..####..#..#######..####..#..#..####..##########..#..####..#..#..#..#
#..#..#..#..#...........#.....#........#.................#..#..#..#..#..#...........#........#..#........#.....#.....#.....#........#..#..#..#..#..#..#
#..#..#..#..#..####..####..#..##########..#######..#######..#..####..#..#..#..####..####..####..#..#######..#..#..#############..#######..#..#######..#
#..#..............#..#.....#..#..#.....#........#........#..#..............#..#..#...........#.....#.....#..#.....#.....#........#..#.....#...........#
#..#..#######..####..####..#..#..####..#..####..####..#..#..#######..#######..#..#############..####..#############..#######..####..####..#..#######..#
#........#..#.....#..#.....#..#........#..#.....#.....#........#..#..#.....#.................#.....#..#........#...........#.....#.....#..#.....#.....#
#######..#..####..#..#..####..####..#############..#######..#..#..#######..#..####..#..#############..#..##########..#######..####..####..#..#..#..####
#........#.....#..#..#..#.....#.....#..#.....#..#.....#.....#..#..#.....#.....#.....#..#.....#.....#.....#..............#..#.....#..#........#..#.....#
#..####..#..####..##########..####..#..#..####..#..#..#..####..#..#..#..####..#..####..#..####..#######..####..#..#######..####..#..####..##########..#
#..#.....#.....#.....#.....#..............#.....#..#..#..#..#........#..#..#..#..#.....#........#..#...........#..#........#..#........#........#.....#
#..####..#..####..####..#..#..####..#..#..####..#..#..#..#..#######..#..#..####..####..#..####..#..#..#######..#######..####..#..#######..####..#..#..#
#.....#..#..............#.....#.....#..#..#........#..#........#.....#..#...........#.....#........#.....#...................................#..#..#..#
####################################################################################################################################################A##
